3 3 3 3 3 3 3 3 3 3 3 3 3 3 3 3 3 3 3 3 3 3 3
3 3 3 3 3 3 3 3 3 3 3 3 3 3 3 3 3 3 3 3 3 3 3
3 6 6 6 6 3 6 6 6 6 6 3 6 6 6 6 6 3 6 6 6 6 3
3 6 3 3 6 6 6 3 6 3 6 6 6 3 6 3 6 6 6 3 3 6 3
3 6 3 3 7 3 3 3 6 3 3 3 3 3 6 3 3 3 7 3 3 6 3
3 6 6 6 6 6 6 6 6 6 6 0 6 6 6 6 6 6 6 6 6 6 3
3 6 3 6 3 3 3 6 3 3 3 0 3 3 3 6 3 3 3 6 3 6 3
3 6 6 6 6 6 6 6 3 6 6 0 6 6 3 6 6 6 6 6 6 6 3
3 6 3 3 3 3 3 6 6 6 3 0 3 6 6 6 3 3 3 3 3 6 3
3 6 6 6 6 6 3 3 6 3 3 3 3 3 6 3 3 6 6 6 6 6 3
3 3 3 6 3 6 3 6 6 6 6 7 6 6 6 6 3 6 3 6 3 3 3
3 4 0 6 3 6 6 6 3 3 3 3 3 3 3 6 6 6 3 6 0 0 3
3 3 3 6 3 6 3 3 3 0 0 5 0 0 3 3 3 6 3 6 3 3 3
3 6 6 6 6 6 6 6 3 3 3 0 3 3 3 6 6 6 6 6 6 6 3
3 6 3 3 3 3 3 6 6 6 6 6 6 6 6 6 3 3 3 3 3 6 3
3 6 6 6 3 6 6 6 3 6 3 3 3 6 3 6 6 6 3 6 6 6 3
3 6 3 6 3 6 3 6 3 6 6 6 6 6 3 6 3 6 3 6 3 6 3
3 6 3 6 3 6 3 6 3 3 3 0 3 3 3 6 3 6 3 6 3 6 3
3 6 6 6 3 6 6 6 3 6 6 6 6 6 3 6 6 6 3 6 6 6 3
3 6 3 7 6 6 3 6 6 6 3 6 3 6 6 6 3 6 6 7 3 6 3
3 6 3 6 3 6 3 3 3 3 3 6 3 3 3 3 3 6 3 6 3 6 3
3 6 6 6 6 6 6 6 6 6 6 6 6 6 6 6 6 6 6 6 6 6 3
3 3 3 3 3 3 3 3 3 3 3 3 3 3 3 3 3 3 3 3 3 3 3
