1 1 1 1 1 1 1 1 1 1 1 1 1 1 1 1 1 1 1 1 1 1 1 1 1
1 6 6 6 1 0 0 0 1 6 6 6 6 6 6 6 1 0 0 0 1 6 6 6 1
1 6 1 6 1 1 1 1 1 6 6 1 1 1 6 6 1 1 1 1 1 6 1 6 1
1 6 6 6 6 6 6 6 6 6 6 6 1 6 6 6 6 6 6 6 6 6 6 6 1
1 6 1 6 1 1 1 1 1 6 1 6 1 6 1 6 1 1 1 1 1 6 1 6 1
1 6 1 6 6 6 6 6 6 6 1 6 6 6 1 6 6 6 6 6 6 6 1 6 1
1 6 1 1 1 1 6 1 1 6 1 1 1 1 1 6 1 1 6 1 1 1 1 6 1
1 6 1 1 1 1 6 1 6 6 6 6 1 6 6 6 6 1 6 1 1 1 1 6 1
1 6 1 1 1 1 6 1 1 1 1 0 1 0 1 1 1 1 6 1 1 1 1 6 1
1 6 1 1 1 1 6 1 0 0 0 0 0 0 0 0 0 1 6 1 1 1 1 6 1
1 6 6 6 6 6 6 1 0 0 0 0 7 0 0 0 0 1 6 6 6 6 6 6 1
1 1 1 1 1 1 6 1 1 0 1 1 1 1 1 0 1 1 6 1 1 1 1 1 1
1 5 0 0 0 0 6 0 0 0 1 0 7 0 1 0 0 7 6 0 0 0 0 4 1
1 1 1 1 1 1 6 1 1 0 1 1 0 1 1 0 1 1 6 1 1 1 1 1 1
1 6 6 6 6 6 6 1 1 0 0 0 0 0 0 0 1 1 6 6 6 6 6 6 1
1 6 1 6 1 1 1 1 1 6 1 6 1 6 1 6 1 1 1 1 1 6 1 6 1
1 6 1 6 1 1 1 1 1 6 1 6 1 6 1 6 1 1 1 1 1 6 1 6 1
1 6 1 6 1 1 1 1 1 6 1 6 1 6 1 6 1 1 1 1 1 6 1 6 1
1 6 1 6 1 1 1 1 1 6 1 6 1 6 1 6 1 1 1 1 1 6 1 6 1
1 6 1 6 1 1 1 1 1 6 1 6 1 6 1 6 1 1 1 1 1 6 1 6 1
1 6 1 6 1 1 1 1 1 6 1 6 1 6 1 6 1 1 1 1 1 6 1 6 1
1 6 1 6 6 6 6 6 6 6 6 6 1 6 6 6 6 6 6 6 6 6 1 6 1
1 6 1 1 1 1 1 6 1 1 1 1 1 1 1 1 1 6 1 1 1 1 1 6 1
1 6 6 6 6 6 6 6 6 6 6 6 6 6 6 6 6 6 6 6 6 6 6 6 1
1 1 1 1 1 1 1 1 1 1 1 1 1 1 1 1 1 1 1 1 1 1 1 1 1
